ARVMBTPNARVMB
R  ARV  MB  T
V  MBTP  N  P
M     N R  VN
BTP  N  TPVBA
T P   RV  P R
P  M    PN  V
N ARVP    g M
ARVMBTPNARVMB
