ARVMBTPNARVMB
R      V    T 
V PNAR MB  PN 
M B  T  P   N 
B TP N   VMBA 
T P  N      R 
P  NARVMBT  V 
N   R   P  gM
ARVMBTPNARVMB